# Gboard Dictionary version:1
thxiizviii	东方三月精	zh-CN
thxvzv	东方凭依华	zh-CN
thxviizv	东方刚欲异闻	zh-CN
thxi	东方地灵殿	zh-CN
thxvi	东方天空璋	zh-CN
thvii	东方妖妖梦	zh-CN
thii	东方封魔录	zh-CN
thiv	东方幻想乡	zh-CN
thxiiizv	东方心绮楼	zh-CN
thv	东方怪绮谈	zh-CN
thixzv	东方文花帖	zh-CN
thxiizv	东方文花帖	zh-CN
thxii	东方星莲船	zh-CN
thiii	东方梦时空	zh-CN
thviii	东方永夜抄	zh-CN
thxivzv	东方深秘录	zh-CN
thi	东方灵异伝	zh-CN
thxiii	东方神灵庙	zh-CN
thvi	东方红魔乡	zh-CN
thxv	东方绀珠转	zh-CN
thxzv	东方绯想天	zh-CN
thix	东方花映冢	zh-CN
thviizv	东方萃梦想	zh-CN
thxviii	东方虹龙洞	zh-CN
thxiv	东方辉针城	zh-CN
thxiiziii	东方非想天则	zh-CN
thx	东方风神录	zh-CN
thxvii	东方鬼形兽	zh-CN
thxiizviii	妖精大战争	zh-CN
thxivziii	弹幕天邪鬼	zh-CN
thxvizv	秘封噩梦日记	zh-CN
